ats.aq	us
tert.am	us
aad.gov.au	au
flixco.info	au
stateheritage.wa.gov.au	au
centcoast.tas.gov.au	au
ac.gov.br	br
free.fr	fr
nsi.bg	bg
passc.net	us
fourseasons.com	us
heritagecentre.ca	us
villageoflougheed.com	us
winnipegfreepress.com	us
stats.gov.cn	cn
inmediahk.net	us
rozna.cz	cz
statistikbanken.dk	dk
insula-moenia.dk	dk
elsalvador.com	us
opera.ee	ee
maanmittauslaitos.fi	fi
unesco.org	fr
culture.gouv.fr	fr
google.com	us
geoportail.gouv.fr	fr
insee.fr	fr
webcitation.org	us
ehess.fr	fr
mairie-breuil-le-vert.fr	fr
bouchard-pereetfils.com	fr
kreisbote.de	de
d-nb.info	de
rpb-rlp.de	de
naturschutzinformationen-nrw.de	de
stadt-koeln.de	de
klosterhotel-woeltingerode.de	de
lagis-hessen.de	de
statistik-nord.de	de
rlp.de	de
youtube.com	us
lutheran.hu	hu
budapestbylocals.com	us
allahabad.nic.in	in
mbcet.ac.in	gb
google.co.in	us
indiarailinfo.com	us
nrsc.gov.in	in
waspada.co.id	id
sslagoss.org	us
istat.it	it
osservatoriobalcani.org	gb
visitjordan.com	us
yandex.ru	ru
4en5mei.nl	nl
dsm.com	nl
kulturminnesok.no	no
bygdeposten.no	no
nscb.gov.ph	ph
www.gov.ph	hk
geoportal.gov.pl	pl
muszyna.pl	pl
stat.gov.pl	pl
sztetl.org.pl	pl
aljazeera.net	us
lege-online.ro	ro
mom.ru	ru
mosclassific.ru	ru
mr-savino.ru	ru
google.ge	us
e-obce.sk	sk
euskaltzaindia.net	fr
ine.es	es
gva.es	es
mengamunoz.es	es
mcu.es	es
google.ca	us
aracena.es	es
smhi.se	se
lansstyrelsen.se	se
runeberg.org	se
massongex.ch	ch
admin.ch	ch
trtc.com.tw	tw
openstreetmap.org	gb
statistics.gov.uk	gb
arun.gov.uk	gb
wiltshiremuseum.org.uk	gb
archive.org	us
croydon.gov.uk	ie
freeuk.com	gb
visitcumbria.com	gb
bbc.co.uk	gb
norfolk.gov.uk	gb
scotrail.co.uk	us
doi.org	us
npor.org.uk	gb
nationaltrust.org.uk	gb
lvivcenter.org	de
weather.in.ua	ua
africancrisis.co.za	us
ine.gub.uy	uy
usgs.gov	us
state.or.us	us
census.gov	us
az.gov	us
naco.org	us
floridaleagueofcities.com	us
prudhoebay.com	us
belknapcounty.org	us
lufkinfirst.com	us
lazeta.fm	us
azcentral.com	us
townofeastonnh.org	us
mta.info	us
cuny.edu	us
fcc.gov	us
maryland.gov	us
nps.gov	us
washington.edu	us
thomas.edu	us
hooksairport.com	us
nwsource.com	us
hollywoodreporter.com	us
eagleridgeacademy.org	us
detroitzoo.org	us
wvculture.org	us
southwest.com	us
njmonthly.com	gb
eoearth.org	us
twitter.com	us
businessweek.com	us
nga.mil	us
abet.org	us
weather.com	us
arwg-gibe.org	us
nytimes.com	us
uiuc.edu	us
fearrington.com	us
utsandiego.com	us
blogspot.com	us
staradvertiser.com	us
shilad.com	us